011111110111111
000001000000000
101011010111111
110000010111111
111010110111111
111011110111111
100001110111111
101011111111111
101000000111111
001011101111111
111111101111111
111111101111111
111111101111111
111111101111111
111111101111111