444111111111144
444444111143444
444224141133411
442222141133111
442222144113111
444221111113333
444000111113333
444104411333322
444114401333222
441111000332222
441111113332222
441111113322222
441441133322222
444444133322222
444444133322222
